
00100001000010000000000000000001
00000001000010010100000000100000
00010001000010101111111111101100
00000001100011000110000000100000
00100101100011001111111111111011
00000001111011110111100000100000
00010101010011001111111111110000
00000001000010000100000000100000
10001101010010010000000000000100
10101101011011100000000000000100
00000001000010000100000000100000
00000001000011110100000000100000
00001000010000000000000000011100
00110100000000100000000000000001
00000001000000000010000000100000
